WWWWWWWWWWWWWWWWWWWWWWWWWWWWWWWWWWWWWWWWWWWWWWWWWWWWWWWWWWWWWWWWWWWWWWWWWWWWWWWW
WWWWWWWWWWWWWWWWWWWWWWWWWWWW                                         WWWWWWWWWWW
WW                    WWWWWWWWWWWWWWWWWWWWWWWWWWWWWWWWWWWWWWWWWWWWWWWWWWWWWWWWWW
WWWW WWWWWWWWWWWWWW WWWWWWWWWWWWWWWWWWWWWWWWWWWWWWWWWWWWWWWWWWWWWWWWWWWWWWWWWWWW
WW                    WWWW                             WWWWWWWWWWWWWWWWWWWWWWWWW
WWW WWWWW    WWWW WWWWWWWWWW WWWWWWWWWW WWWWWWWWWWWWWWWWWWWWWWWWWWWWWWWWWWWWWWWW
WW                              WWWW     WWWWWWWWWWWWWWWWWWWWWWWWWWWWWWWWWWWWWWW
WWWWWWWWWWWWWWWWWWWWWWW WWWWWWWWWWWWW WWWWWWWWWW                              WW
WWWWWWWWWWWWWWWWWWWWWWW WWWWWWWWWWWW    WWWWWWWWWW WWWWWWWWWWWWWWWWWWWWWWWWWWW W
WWWW               S     WWWWWWWWWWW  WWWWWWWWWWWW WWWWWWWWWWWWWWWWWWWWWWWWWW  W
WWWW WWWWWWWWWWWWWWWWWWWWWWWWWWWWWWW WWWWWWWWWWWWW WWWWWWWWW WWWWWWWWWWWWWWWW  E
WWW          WWWWWWWWWWWWWWWW                       WWWWWWW                  W W
WWWWWWWWW WWWWWWWWWWWWWWWWWWWWWWWWWWWW WWWWW   W WWWWWWWWW   WWWWWWWWWWWWWWWWW W
WWWWWWWWW WWWWWWWWWWWWWWWWWWWWWWWWWWW  WWWWWWWW  WWWWWWWWWW  WWWWWWWWWWWWWWWWW W
WWWWW        WWWWWWWWWWWWWWWW                        WWWWWW  WWWWWWWWWWWWWWWWW W
WWWWWWWWW WWWWWWWWWWWWWWWWWWW           WWWWWWWWWWWWWWWWWWW WWWWWWWWWWWWWWWWWW W
WWWWWWWWW         WWWWWWWWWWWWWWWWW  WWWWWWWWWWWW                  WWWWWWWWW   W
WWWWWWWWWWWWWWWW  WWWWWWWWWWWWWWWWW     WWWWWWWWWWWWWWW WWWWWWWWWWWWWWWW     W W
WWWWW                   WWWWWWWW                  WWWWWW           WWWWW WWWWW W
WWWWWWWW WWWWWWWWWWWWWWWWWWWWWWWWWWWWWWWWWWWWW WWWWWWWWW             WWW WWWWW W
WWWWWW               WWWWWWWWWWWWWWWWWWWWWWWWW WWWWWWWWW                       W
WWWWWWWWWWWWWWWWWWWW WWWWWWWWWW                WWWWWWWWWWWWWWWWWWW WWWWWWWWWWWWW
WWWWWWWWWWWWWWWWWWWW WWWWWWWWWW WWWWWWWWWWWWWWWWWWWWWWWWWWWWWWWWWW       WWWWWWW
WWWWWWWWWW           WWWWWWWWW   WWWWWWWWWWWWWWWWWWWWWWWWWWWWWWWWWWWWWWW WWWWWWW
WWWWWWWWWW WWWWWWWWWWWWWWWWWW    WWWWWWWWWWWWWWWWWWWW                      WWWWW
WWWWWWWWWW       WWWWWWWWWW      WWWWWWWWWWWWWWWWWWWWWWWWWWWWWWWWWWWW WWWWWWWWWW
WWWWWWWWWWWWWWWW WWWWWWWWW       WWWWWWWWWWWWWWWWWWWWWWWWWWWWWWWWW           WWW
WWWWWWWWWWWWWWWW WWWWWWWWWWWW WWWWWWWWWWWWWWWWWWWWWWWWWWWWWWWWWWWWWWWWW  WWWWWWW
WWWWWWWWWWWWWWWW WWWWWWWWWW    WWWWWWWW                  WWWWWWWWWWWWWW   WWWWWW
WWWWWWWWWWWWWW    WWWWWWWWWWW WWWWWWWWWWW           WWWWWWWWWWWWWWWW     WWWWWWW
WWWWWWWWWWWWW      WWWWWWWWW  WWWWWWWWWWW       WWWWWWWWWWWWWWWWWW      WWWWWWWW
WWWWWWWW                                         WWWWWWWW                WWWWWWW
WWWWWWWW     WWWWWWWWWWWWWWWWWWWWWWWWWWWWW       WWWWWWWWWWWWWWWWWWW WWWWWWWWWWW
WWWWWWWW               WWWWWWWWWWWWWWWWWWWWWW                WWWWWWW WWWWWWWWWWW
WWWWWWWWWWWWWWWW                   WWWWWWWWWWWWWWWWWWWWWWWWWWWWWWWWW WWWWWWWWWWW
WWWWWWWWWWWWWWWWWWWWWW WWWWWWWWW                           W              WWWWWW
WWWWWWWWWWWWWW            WWWWWWWWWWWWWWWWWWWWWWWWWWWWWWWWWWWW WWWWWWWWWWW WWWWW
WWWWWWWWWWWWWW                WWWWWWWWWWWWWWWWWWWWWWWWWWWW     WWWWWWWWWWW WWWWW
WWWWWWWWWWWWWWWWWWWW                 WWWWWWWWWWWWWWWWWWWW  WWWWWWWWWWWWWWW  WWWW
WWWWWWWWWWWWWWWWWWW    WWWWWWWWWWWWWWWWWWWWWWWWWWWWWWWWW   WWWWWWWWWWWWWWW  WWWW
WWWWWWWWWWWW              WWWWWWWWWWWWWWWWWWWWWWWWWWWWWWWW WWWWWWWWWW        WWW
WWWWWWWWWWWWWWWWW           WWWWWWWWWWWWWWWWWWWWWWWWWWWWWW WWWWWWWWW  WWWWWWWWWW
WWWWWWWWWWWW               WWWWWWWWWWWWWWWW           WWWW WWW          WWWWWWWW
WWWWWWWWWWWWWWWWWWW WWWWWWWWWWWWWWWWWWWWWWWWWWWWWWWWWWWWWW WWW WWWWWWWWWWWWWWWWW
WWWWWWWWW            WWWWWWWWWWWWWWWWWWWWWWWWWWWWWWWWWWWWW WWW WWWWWWWWWWWWWWWWW
WWWWWWWWWWWWWWWWWWW WWWWW         WWWWWWWWWWWWWWWWWWWWW         WWWWWWWWWWWWWWWW
WWWWWWWWWWWWWWWWWWW WWWWWWWWWWWWWWWWWWWWWWWWWWWWWWWWWWWWWWWWWW      WWWWWWWWWWWW
WWWWWWWWWWW          WWWWWWWWWWWWWWWWWWWWWW       WWWWWWWWWW    WWWWWWWWWWWWWWWW
WWWWWWWWWWWWWWWWWWW         WWWWWWWWWWWWW   WWW     WWWWWWWW    WWWWWWWWWWWWWWWW
WWWWWWWWWWWWWWWW            WWWWWWWWWWWWW   WWWWW    WWWWWW       WWWWWWWWWWWWWW
WWWWWWWWWWW              WWWWW       WW     WWWWWW   WWWWWWWWWWW    WWWWWWWWWWWW
WWWWWWWWWWWWWWWWWWWWWWW         WWW      WWWWWWWWWW                     WWWWWWWW
WWWWWWWWWWWWWWWWWWWWWWWWWW    WWWWWWWWWWWWWWWWWWWWWWWWWWWWWWWWWWWWWWWWWWWWWWWWWW
WWWWWWWWWWWWWWWWWWWWWWWWWWW WWWWWWWWWWWWWWWWWWWWWWWWWWWWWWWWWWWWWWWWWWWWWWWWWWWW
WWWWWWWWWWWWWWWWWWWWWWWWWWW WWWWWWWWWWWWWWWWWWW           WWWWWWWWWWWWWWWWWWWWWW
WWWWWWWWWWWWWWWWWWWWWWWWWW                                WWWWWWWWWWWWWWWWWWWWWW
WWWWWWWWWWWWWWW             WWWWWWWWWWWWWWWWWWWWWW  WWWWWWWWWWWWWWWWWWWWWWWWWWWW
WWWWWWWWWWWWWWWWWWWWWWWWW WWWWW          WWWWWWWWW  WWWWWWWWWWWWWWWWWWWWWWWWWWWW
WWWWWWWWWWWWWWWWWWWWWWWWW WWWWWWWWWWWWWWWWWWWWWWWW WWWWWWWWWWWWWWWWWWWWWWWWWWWWW
WWWWWWWWWWWWWWWWWWWWWWWW  WWWWWWWWWWWWWWWWWWWWWW            WWWWWWWWWWWWWWWWWWWW
WWWWWWWWWWWWWWWWWWWWWWWW WWWWWWWWWWWWWWWWWWWWWWWWWWWWWWWWWW WWWWWWWWWWWWWWWWWWWW
WWWWWWWWWWWWWWWWW                         WWWWWWWWWWWWWWWWW               WWWWWW
WWWWWWWWWWWWWWWWWWWWWWW  WWWWWWWWWWWWWWWWWWWWWWWWWWWWWWWWWWW WWWWWWWWWWWWWWWWWWW
WWWWWWWWWWWWWWWWWWWWWWW WWWWWWWWWWWWWWWWWWWWWWWWWWWWWWWWWWWW WWWWWWWWWWWWWWWWWWW
WW                        WWWWWWWWWWWWWWWWWWWWWW       WWWWW WWWWWWWWWWWWWWWWWWW
WWWWWWWWWWWWWWWWWWWWWWW WWWWWWWWWWWWWWWWWWWWWWWWWWWWWWWWWWWW WWWWWWWWWWWWWWWWWWW
WWWWWWWWWWWWWWWWWWWWWWW WWWWWWWWWWWWWWWWWWWWWWWWWWWWWWWWWWWW WWWWWWWWWWWWWWWWWWW
WWWWWWWWWWWWWWWWWW       WWWWWWWWWWWWWWWWWWWWWWWW                     WWWWWWWWWW
WWWWWWWWWWWWWWWWWWWWWWW WWWWWWWWWWWWWWWWWWWWWWWWWWWWWWWWWWW  WWWWWWWWWWWWWWWWWWW
WWWWWWW                       WWWWWWWWWWWWWWWWWWWWWWWWWWWWWW WWWWWWWWWWWWWWWWWWW
WWWWWWWWWWWWWWWWWWWWWW  WWWWWWWWWWWWWWWWWWWWWWWW                WWWWWWWWWWWWWWWW
WWWWWWWWWWWWWWWWWWWWWW  WWWWWWWWWWWWWWWWWWWWWWWWWWWWWWWWWWWW WWWWWWWWWWWWWWWWWWW
WWWWWWWWWWWWWWW             WWWWWWWWWWWWWWWWWWWWWWWWWWWWWWWW  WWWWWWWWWWWWWWWWWW
WWWWWWWWWWWWWWWWWWWWW  WWWWWWWWWWWWWWWWWWWWWWWWWWWWWWWWWWWWW WWWWWWWWWWWWWWWWWWW
WWWWWWWWWWWWWWWWWWWWW WWWWWWWWWWWWWWWWWWWWWWWWW               WWWWWWWWWWWWWWWWWW
WWWWWWWWW              WWWWWWWWWWWWWWWWWWWWWWWWWWWWWWWWWWWWWWWWWWWWWWWWWWWWWWWWW
WWWWWWWWWWWWWWWWWWWWWWWWWWWWWWWWWWWWWWWWWWWWWWWWWWWWWWWWWWWWWWWWWWWWWWWWWWWWWWWW
WWWWWWWWWWWWWWWWWWWWWWWWWWWWWWWWWWWWWWWWWWWWWWWWWWWWWWWWWWWWWWWWWWWWWWWWWWWWWWWW
WWWWWWWWW                     WWWWWWWWWWWWWWWWWWWWWWWWWWWWWWWWWWWWWWWWWWWWWWWWWW
WWWWWWWWWWWWWWWWWWWWWWWWWWWWWWWWWWWWWWWWWWWWWWWWWWWWWWWWWWWWWWWWWWWWWWWWWWWWWWWW
261
