WWWWWWWWWWWWWWWWWWWWWWWWWWWWWWWWWWWWW
W                                   W
W                                   W
W                                   W
W                 W  WW             W
W                 W  WW             W
W                 W  WW             W
W                 W  WW             W
W                 W  WW             W
W                 W  WW             W
W                 W  WW             W
W S               W  WW            EW
W                 W  WW             W
W                 W  WW             W
W                 W  WW             W
W                 W  WW             W
W                 W  WW             W
W                 W  WW             W
W                 W  WW             W
W                 W  WW             W
W                 W  WW             W
W                                   W
W                                   W
W                                   W
WWWWWWWWWWWWWWWWWWWWWWWWWWWWWWWWWWWWW
49
