WWWWWWWWWWWWWWWWWWWWWWWWWWWWWWWWWWWWWWWWWWWWWWWWWWWWWWWWWWWWWWWWWWWWWWWWWWWWWWWWW
WS  W   W     W     W     W     W W     W       W     W W   W         W W   W   W
W WWW W WWW W WWW W WWWWW WWW W W WWWWW W WWW W WWW W W WWW W W WWW WWW W W WWW W
W W   W W W W W W W           W W W       W   W     W W     W W   W   W   W   W W
W WWW WWW WWW W WWWWW W WWWWWWWWW W WWWWWWWWWWW WWWWW WWW W WWWWWWWWW WWW WWWWW W
W     W   W   W       W W     W   W W           W W W   W W     W               W
W WWWWWWW W WWW WWWWWWWWWWWWW WWW WWWWWWW W W WWW W WWW WWW WWWWWWW W WWWWW WWW W
W   W W   W   W     W W W     W W   W W   W W       W   W       W W W W     W   W
W W W WWW W WWWWW W W W W WWW W W W W WWWWWWWWW W WWW WWW WWWWW W W WWWWWWW WWWWW
W W               W     W W W   W W     W     W W   W   W W   W   W     W W W W W
WWW W WWWWW WWW W W W WWWWW WWW W WWW WWWWW WWW WWWWW WWW WWW W WWWWW WWW WWW W W
W   W   W     W W W W   W   W   W W W W W W     W       W W     W     W W   W   W
WWW W WWWWWWW WWW WWWWWWW WWW WWWWW W W W WWWWWWWWW W WWWWW WWW WWW WWW W WWW WWW
W   W W         W W     W       W     W     W   W   W   W W   W W     W         W
WWW W WWWWWWWWWWWWWWW WWWWW W WWW WWW WWW WWWWW WWW WWWWW WWWWW W W WWW W W WWW W
W W W   W         W       W W W W W   W   W   W         W W W     W W W W W W W W
W WWW WWWWWWW W W WWW W WWWWW W W WWW W WWWWW WWW W WWWWW W W WWWWW W WWWWW W W W
W   W       W W W     W W     W     W W     W W   W   W     W     W     W     W W
WWW W W WWW W WWW W WWWWWWW WWW W WWWWW WWW W WWWWW W W WWWWWWWWWWWWWWW W WWWWW W
W W   W W   W W   W     W       W   W   W     W W   W     W   W W   W W   W W   W
W WWWWW WWW WWWWW W W WWWWWWW WWWWWWWWW WWWWW W WWW WWW WWWWW W W WWW W W W WWW W
W W   W W W       W W     W   W W       W   W W   W   W     W W       W W W   W W
W WWW WWW WWW WWWWWWWWW WWWWW W W WWWWW W WWWWW WWW W W W W W WWWWW WWW WWW WWW W
W       W   W     W     W     W   W       W     W W W W W W   W   W   W   W     W
W WWWWW W WWWWWWWWWWWWW WWWWW WWW W WWW WWWWWWW W W W W W WWWWWWW WWW W WWWWWWWWW
W W     W           W     W W   W W   W   W W W     W W W   W W W             W W
WWWWWWW W W WWWWW WWWWWWW W W WWW WWW WWWWW W W W W WWW W WWW W W W WWW WWWWWWW W
W         W W       W               W W     W W W W W W W   W   W W W   W W   W W
W W WWW WWW W WWW W WWW WWW WWWWW WWWWWWW WWW WWWWWWW WWW W W WWW WWW WWW WWW W W
W W W     W W W   W W   W   W     W   W   W         W   W W       W W   W       W
WWWWW WWWWW W WWW WWW W WWW W W WWWWW WWW W WWW W WWWWW WWW W WWW W W W WWWWW WWW
W W W W     W   W     W   W W W W         W W W W W       W W W W W   W   W     W
W W WWWWWWWWWWWWWWW WWW W WWWWWWWWWWW WWWWW W W WWW WWW WWW W W WWWWW WWW W W WWW
W W W       W   W   W W W     W               W   W W       W   W W W W     W W W
W W W WWW W W WWW WWW WWWWWWW WWWWW WWW W WWWWWWW WWWWWWWWW WWWWW W W WWWWW WWW W
W   W W W W   W W W W     W   W     W W W   W W     W     W   W W     W W   W   W
W W W W WWW W W W W W WWWWWWWWWWW WWW WWWWW W W WWW WWWWW W WWW W W WWW WWW WWW W
W W     W   W W W       W W   W   W     W   W   W   W     W W W W W     W   W   W
W WWW WWWWWWW W WWW WWW W W WWWWWWWWWWW W WWW WWW W WWW WWWWW W WWW WWW WWW W W W
W W   W     W   W W   W   W     W     W W W W W W W   W         W     W W     W W
WWW WWWWWWW W WWW WWWWWWW WWWWW W WWW W WWW W W W W W W WWWWWWW W WWWWW WWW W WWW
W   W     W       W     W W     W W W     W     W W W W W   W     W   W   W W   W
WWWWW WWW W WWW WWWWWWW W W WWWWWWW WWW WWWWW WWWWWWWWW W WWW WWWWW WWWWWWWWW WWW
W   W W W W W W W       W   W     W   W W   W   W   W W W               W   W   W
WWW W W WWWWW W W WWWWWWWWW WWW WWW W W W W WWW WWW W W W WWWWW W W WWWWW WWW WWW
W     W         W         W       W W     W     W W   W W   W   W W       W     W
WWW W W W W W WWWWW W WWWWWWWWW WWW W W W WWWWWWW W WWW W W W W W WWWWW W WWWWW W
W   W W W W W W     W   W     W W W W W W   W     W   W W W W W W W W   W   W W W
W W WWW WWW WWW W WWWWWWWWWWW W W W WWW WWWWW WWW W WWW W WWWWWWW W WWW WWW W W W
W W     W W W W W   W   W   W W   W W W W W   W         W W     W W       W   W W
W WWWWWWW WWW W WWW WWW WWW W W WWWWW W W W WWWWWWWWW WWWWWWWWW WWWWWWW WWW WWW W
W         W     W W W   W         W   W W W W W         W   W W W   W     W   W W
WWW W W W WWW WWW WWW W W W WWW W W WWW W W W W WWW WWWWW WWW W W W W WWWWWWW W W
W W W W W W   W W W   W W W   W W   W   W     W W     W         W W   W       W W
W W WWW W W WWW W W WWW WWWWWWWWW WWW WWW WWW WWWWWWWWWWWWW W WWWWW W WWW WWWWWWW
W W   W W W         W W   W W     W W     W         W W     W   W W W W W   W   W
W WWW W WWWWWWWWW WWW WWWWW WWW WWW WWW W W WWW WWWWW WWW WWW W W W W W WWWWW WWW
W W   W W     W     W W     W W W   W   W W   W   W W     W   W   W W   W       W
W WWWWW WWW WWWWW W W W W W W W W WWW W W W WWWWWWW WWW W W WWWWWWWWW WWW WWW W W
W       W   W W W W   W W W           W W W W     W     W W   W     W       W W W
W WWWWW WWW W W W W W WWWWW WWW WWWWW WWWWW WWWWW W WWW WWWWW W WWWWW WWW WWW W W
W   W           W W W W     W   W   W W   W W W W   W     W     W   W W     W W W
W WWW W WWWWWWWWW WWWWWWW WWW W W W W W WWWWW W WWWWW WWWWWWWWW W WWWWW WWW W WWW
W W W W W     W   W     W W W W W W           W W           W W     W     W W   W
WWW WWW W W W W W WWWWW WWW WWW WWW WWWWWWW WWW W WWW W WWWWW WWW WWW W WWWWWWWWW
W W W W   W W W W W     W W     W   W       W W   W   W W     W W   W W       W W
W W W WWW WWWWWWW W WWW W WWW W WWW W W W WWW WWW W WWW W W WWW WWW WWW W WWWWW W
W W   W   W W   W W W W       W W   W W W     W W W   W W W           W W   W   W
W W WWW W W W W W W W WWW WWWWWWWWWWWWWWW WWW W W WWW WWW WWW WWWWW W W WWW W WWW
W       W   W W W       W W   W W       W   W W   W W W W   W   W   W W   W W W W
WWW WWWWW WWW WWWWW WWW W WWW W WWW WWWWWWWWW WWW W W W WWWWW W WWWWWWWWWWW W W W
W       W   W         W W   W W           W   W     W   W W   W W   W   W       W
WWWWW WWWWW W WWW W WWW WWW W WWW W W WWW W WWWWW WWWWWWW WWW WWW W W W WWWWW WWW
W         W   W   W   W   W     W W W W W W       W W W           W W W       WEW
WWW WWWWW WWW W W WWWWW WWW WWW WWWWWWW W W W WWWWW W W W WWW W W WWWWW W WWW W W
W W W W     W W W W W     W W W     W   W   W W   W W   W W   W W W W   W W   W W
W W W WWWWWWW W W W W WWW W W W WWWWW WWWWW WWW W W WWWWW W WWW WWW WWWWWWW W W W
W     W   W W W W   W   W W   W   W   W W       W   W   W W   W       W     W W W
W WWW W W W WWW WWWWW WWWWW W W W W WWW W WWW WWW W W WWWWWWWWW WWW W WWW W WWW W
W W     W   W       W W     W W W       W   W W   W W           W   W   W W     W
WWWWWWWWWWWWWWWWWWWWWWWWWWWWWWWWWWWWWWWWWWWWWWWWWWWWWWWWWWWWWWWWWWWWWWWWWWWWWWWWW
250
