WWWWWWWWWWWWWWWWWWWWWWWWWWWWWWWWWWWWWWWWWWWWWW
E                                            W
WWWWWWWWWWWWWWWWWWWWWWWWWWWWWWWWWWWWWWWWWWWW W
W                                            W
W WWWWWWWWWWWWWWWWWWWWWWWWWWWWWWWWWWWWWWWWWWWW
W                                            W
WWWWWWWWWWWWWWWWWWWWWWWWWWWWWWWWWWWWWWWWWWWW W
W                                            W
W WWWWWWWWWWWWWWWWWWWWWWWWWWWWWWWWWWWWWWWWWWWW
W W                                          W
W W WWWWWWWWWWWWWWWWWWWWWWWWWWWWWWWWWWWWWWWW W
W W W                                        W
W W W WWWWWWWWWWWWWWWWWWWWWWWWWWWWWWWWWWWWWWWW
W W W W                                     SW
W W W W WWWWWWWWWWWWWWWWWWWWWWWWWWWWWWWWWWWWWW
W W W W                                      W
W W W W WWWWWWWWWWWWWWWWWWWWWWWWWWWWWWWWWW W W
W W W                                      W W
W W WWWWWWWWWWWWWWWWWWWWWWWWWWWWWWWWWWWWWWWW W
W                                            W
WWWWWWWWWWWWWWWWWWWWWWWWWWWWWWWWWWWWWWWWWWWWWW
314
