WWWWWWWWWWWW
W   W S  W E
W W  WWW W W
W W      W W
W WWWWWWWW W
W          W
WWWWWWWWWWWW
31
