WWWWWWWWWWWWWWWWWWWWWWWWWWWWWW
E                            W
W                            W
W                            W
W                            W
W                            W
W                            W
W                            W
W                            W
W                            W
W                            W
W                            W
W                            W
W                            W
W                            W
W                            W
W                            W
W                            W
W                            W
W                            W
W                            W
W                            W
W                            W
W                            W
W                            W
W                            W
W                            W
W                            W
W                           SW
WWWWWWWWWWWWWWWWWWWWWWWWWWWWWW
55
