WWWWWWWWWWWWWWWWWWWWWWWWWWWWWWWWWWWWWWWWWWWWWWWWWWWWWWWWWWWWW
WSW W W W   W       W   W             W       W       W   W W
W W W W W W WWW WWW WWW W W WWW W W WWW WWWWWWWWW WWWWWWW W W
W   W   W W W   W   W     W W   W W           W   W W   W   W
W W W W W W WWWWW WWW WWWWWWW WWW WWW WWW WWWWWWW W W WWWWW W
W W   W   W   W   W         W   W   W   W       W       W   W
W W W WWW WWWWWWW W WWWWWWW W W WWW WWWWWWWWWWW W WWWWWWWWW W
W W W W W     W   W W W   W W W   W   W       W W   W W W   W
WWW WWW WWWWW WWW WWW W WWW WWWWW WWW WWWWW W W W W W W W WWW
W   W W W   W   W       W W W       W W   W W W W W W       W
WWW W W WWW WWW W W W W W W WWWWW WWWWW WWW WWW W W W WWW WWW
W W W   W   W     W W W   W   W         W W   W   W     W W W
W W W WWW WWW WWW W WWW WWWWWWW WWWWW W W W WWW WWWWWWW WWW W
W   W W W     W W W W   W W     W W   W W   W         W W   W
WWWWW W WWW WWW W WWW WWW W WWW W WWW WWWWW WWW WWW WWWWW W W
W W W   W   W   W   W   W   W   W     W     W   W W W     W W
W W W WWWWWWW WWW W WWWWW W WWWWWWWWWWW WWWWW WWW W WWW WWWWW
W     W W W   W   W W   W W   W W     W     W W       W W   W
WWW W W W W W W WWW W WWWWW W W WWWWW WWWWW WWW WWWWW W W WWW
W W W   W   W     W     W W W W       W W W W       W   W W W
W WWW W W WWW WWW W WWW W WWWWW WWW W W W W W WWWWW W WWW W W
W   W W   W     W W W           W W W W   W     W W W     W W
WWW W WWW W WWWWW WWWWW W WWWWW W W WWWWW WWW WWW WWW WWW W W
W W   W W W     W   W W W     W W W   W   W   W       W     W
W WWW W W WWWWWWW W W W WWWWWWWWW WWW WWW WWW WWWWWWWWWWW W W
W     W   W W     W   W     W W     W     W         W     W W
W WWWWW W W W WWW W WWWWW WWW W W W WWW WWW WWWWWWW WWW WWWWW
W     W W   W   W W W W W W     W W       W   W     W     W W
W W WWW W W W W W WWW W WWW WWWWW W W WWW WWW W W W WWW W W W
W W   W W W W W W   W   W W   W   W W W W   W W W W   W W W W
WWWWW WWWWWWWWW WWWWW WWW WWWWWWWWWWW W W W WWW WWW W WWW W W
W         W       W                 W W W W   W W   W   W W W
WWW W W WWWWW WWW WWWWWWWWW W WWW WWWWW WWW W W WWW W WWWWW W
W   W W W       W   W W     W W             W     W W       W
W WWWWWWW WWW WWWWW W WWWWWWWWWWWWWWWWWWWWWWW WWWWWWW W W W W
W W       W   W   W   W W   W   W W           W W W   W W W W
W W WWWWW W W W WWWWW W WWW WWW W WWW W WWW W W W W WWW W WWW
W W   W W W W W   W     W W W       W W W   W W W     W W   W
W WWW W W WWW W WWWWWWW W W W W W W WWW WWW W W W W WWWWWWWWW
W   W W     W W           W   W W W     W   W   W W         E
WWWWWWWWWWWWWWWWWWWWWWWWWWWWWWWWWWWWWWWWWWWWWWWWWWWWWWWWWWWWW
121
