WWWWWWWWWWWWWWWWWWWWWWWWWWWWWWWW
W W W W W W W W W W W W W W W  E
W W W W W W W W W W W W W W   WW
W W W W W W W W W W W W W      W
W W W W W W W W W W W W      WWW
W W W W W W W W W W W          W
W W W W W W W W W W         WWWW
W W W W W W W W W W            W
W W W W W W W W W          WWWWW
W W W W W W W W                W
W W W W W W W W W W W     WWWWWW
WS                             W
WWWWWWWWWWWWWWWWWWWWWWWWWWWWWWWW
40
